50 50 50 50 26 26 26 26 26 26 26 26 26 26 26 26 26 26 26 26 26 26 26 26 26 26 26 26 26 26 26 26 26 26 26 26 26 26 26 26 26 26 26 26 26 26 26 26 26 49 49 49 49 49 49 49 49 49 49 49 49 49 49 49 49 49 49 49 49 49 49 49 49 49 49 49 49 49 49 49 49 49 49 49 49 49 49 49 49 49 49 49 49 49 49 49 49 49 49 49 49 49 49 49 49 49 49 49 49 49 49 49 49 49 49 49 49 49 49 49 49 49 49 49 49 49 49 49 49 49 49 49 49 49 49 49 49 49 49 49 49 49 49 49 49 49 49 49 49 49 49 49 49 49 49 49 49 49 49 49 49 49 49 49 49 49 49 49 49 49 49 49 49 49 49 49 49
50 50 26 26 26 26 26 26 26 26 26 26 26 26 26 26 26 26 26 26 26 26 26 26 26 26 26 26 26 26 26 26 26 26 26 26 26 26 26 26 26 26 26 26 26 26 26 26 26 49 49 49 49 49 49 49 49 49 49 49 49 49 49 49 49 49 49 49 49 49 49 49 49 49 49 49 49 49 49 49 49 49 49 49 49 49 49 49 49 49 49 49 49 49 49 49 49 49 49 49 49 49 49 49 49 49 49 49 49 49 49 49 49 49 49 49 49 49 49 49 49 49 49 49 49 49 49 49 49 49 49 49 49 49 49 49 49 49 49 49 49 49 49 49 49 49 49 49 49 49 49 49 49 49 49 49 49 49 49 49 49 49 49 49 49 49 49 49 49 49 49 49 49 49 49 49 49
50 26 26 26 26 26 26 26 26 26 26 26 26 26 26 26 26 26 26 26 26 26 26 26 26 26 26 26 26 26 26 26 26 26 26 26 26 26 26 26 26 26 26 26 26 26 26 26 26 49 49 49 49 49 49 49 49 49 49 49 49 49 49 49 49 49 49 49 49 49 49 49 49 49 49 49 49 49 49 49 49 49 49 49 49 49 -1 -1 -1 -1 -1 -1 -1 -1 -1 -1 -1 -1 49 49 49 49 49 49 49 141 141 141 141 49 49 49 49 49 49 49 49 49 49 49 49 49 49 49 49 49 49 49 49 49 49 49 49 49 49 49 49 49 49 49 49 49 49 49 49 49 49 49 49 49 49 49 49 49 49 49 49 49 49 49 49 49 49 49 49 49 49 49 49 49 49 49 49 49 49 49 49
50 26 26 0 0 0 0 0 0 0 0 0 0 0 0 0 0 0 0 0 0 0 0 0 0 0 0 0 0 0 0 0 0 0 0 0 0 0 0 0 0 0 0 0 0 0 0 0 0 0 0 0 0 0 0 0 0 0 0 49 49 49 49 0 0 0 0 0 0 0 0 0 0 0 0 0 0 0 0 0 0 0 0 0 0 0 -1 -1 -1 -1 -1 -1 -1 -1 -1 -1 -1 -1 49 49 49 49 49 49 49 141 141 141 141 49 49 49 49 49 49 49 49 49 49 49 49 49 49 49 49 49 49 49 49 49 49 49 49 49 49 49 49 49 49 49 49 49 49 49 49 49 49 49 49 49 49 49 49 49 49 49 49 49 49 49 49 49 49 49 49 49 49 49 49 49 49 49 49 49 49 49 49
50 26 26 -1 -1 -1 -1 -1 -1 -1 -1 -1 -1 -1 -1 -1 0 0 0 0 -1 -1 -1 -1 -1 -1 -1 -1 0 0 0 0 0 0 -1 -1 -1 -1 -1 -1 -1 -1 -1 -1 -1 -1 -1 -1 -1 -1 -1 -1 -1 -1 -1 -1 -1 -1 -1 94 49 72 49 -1 -1 0 0 0 0 -1 -1 -1 -2 -1 -1 -1 -1 -1 -1 -1 -1 -1 -1 -1 -1 -1 -1 -1 -1 -1 -1 -1 -1 -1 -1 -1 -1 -1 -1 -1 -1 -1 -1 145 145 141 141 141 141 141 118 118 118 118 118 118 118 118 118 118 118 118 118 118 118 118 118 118 118 118 118 118 118 118 417 417 417 417 417 417 417 417 417 417 417 417 417 417 417 417 417 417 417 417 417 417 417 417 417 417 417 417 417 417 417 417 417 417 417 417 417 417 417 417 417 417 49
50 26 26 -1 -1 -1 -1 -1 -1 -1 -1 -1 -1 -1 -1 -1 -1 -1 -1 -1 -1 -1 -1 -1 -1 -1 -1 -1 -1 -1 -1 -1 -1 -1 -1 -1 -1 -1 -1 -1 -1 -1 -1 -1 -1 -1 -1 -1 -1 -1 -1 -1 -1 -1 -1 -1 -1 -1 -1 94 94 72 49 -1 -1 -1 -1 -1 -1 -1 -1 -1 -1 -1 -1 -1 -1 -1 -1 -1 -1 -1 -1 -1 -1 -1 -1 -1 -1 -1 -1 -1 -1 -1 -1 -1 -1 0 0 0 0 0 0 169 169 141 141 141 141 141 141 141 141 141 141 141 141 141 141 141 141 141 141 141 141 141 141 141 141 141 141 141 141 141 446 -1 -1 -1 -1 -1 -1 -1 -1 -1 -1 -1 -1 -1 -1 -1 -1 -1 -1 -1 -1 -1 -1 -1 -1 -1 -1 -1 -1 -1 -1 -1 -1 -1 -1 -1 -1 -1 -1 -1 -1 -1 49
50 26 26 -1 -1 -1 -1 -1 -1 -1 -1 -1 -1 -1 -1 -1 -1 -1 -1 -1 -1 -1 -1 -1 -1 -1 -1 -1 -1 -1 -1 -1 -1 -1 -1 -1 -1 -1 -1 -1 11 12 -1 -1 -1 -1 -1 -1 -1 -1 -1 -1 -1 -1 -1 -1 -1 -1 -1 94 94 72 49 0 0 0 60 0 0 0 0 60 0 0 0 0 0 0 0 0 -1 -1 -1 -1 -1 -1 -1 -1 -1 -1 -1 -1 -1 -1 -1 -1 -1 -1 0 0 0 0 0 169 191 192 141 141 141 141 141 141 141 141 141 141 141 141 141 141 141 141 141 141 141 141 141 141 141 141 141 141 141 141 446 -1 514 515 515 515 -1 -1 -1 -1 -1 -1 -1 -1 -1 -1 -1 -1 -1 -1 -1 -1 -1 -1 -1 -1 -1 -1 -1 -1 -1 -1 -1 -1 -1 -1 -1 -1 -1 -1 -1 -1 49
50 26 26 -1 -1 -1 -1 -1 -1 -1 -1 -1 -1 -1 -1 -1 -1 -1 -1 -1 -1 -1 -1 -1 -1 -1 -1 -1 -1 -1 -1 -1 3 3 3 3 3 3 3 3 3 3 3 3 3 3 3 3 2 3 -1 -1 -1 -1 -1 -1 -1 -1 -1 94 49 72 49 3 3 3 3 3 3 3 3 3 3 3 3 3 3 3 3 0 -1 -1 -1 -1 -1 94 48 48 48 48 48 48 -1 -1 -1 -1 -1 -1 -1 94 72 72 72 72 72 72 72 141 141 141 141 141 141 141 141 141 141 141 141 141 141 141 141 141 141 141 141 141 141 141 141 141 141 141 446 -1 -1 -1 -1 -1 -1 -1 -1 49 49 49 49 49 -1 -1 -1 -1 -1 -1 -1 -1 -1 -1 -1 -1 -1 -1 -1 -1 -1 -1 -1 -1 -1 -1 -1 -1 -1 -1 -1 -1 49
50 50 26 -1 -1 -1 -1 -1 -1 -1 -1 -1 -1 -1 -1 -1 -1 -1 -1 -1 -1 -1 -1 -1 -1 -1 -1 -1 -1 -1 -1 -1 26 26 26 26 26 26 26 26 71 50 48 48 48 48 48 48 48 48 -1 -1 -1 -1 -1 -1 -1 -1 -1 94 49 72 49 49 49 49 49 49 49 49 49 49 49 49 49 49 49 49 49 0 461 461 -1 -1 -1 94 48 48 48 48 48 48 -1 -1 -1 -1 -1 -1 -1 94 48 72 72 72 72 72 72 139 141 141 141 141 141 141 141 141 141 141 141 141 141 141 141 141 141 141 141 141 141 141 141 141 141 141 514 514 514 -1 27 27 492 -1 -1 49 49 49 49 49 -1 -1 -1 -1 -1 -1 -1 -1 -1 -1 -1 -1 -1 -1 -1 -1 -1 -1 -1 -1 -1 -1 -1 -1 -1 -1 -1 -1 49
50 50 26 -1 -1 -1 59 60 61 -1 -1 -1 -1 -1 59 60 61 -1 -1 -1 59 60 61 -1 -1 -1 -1 -1 -1 -1 -1 -1 26 26 26 26 26 26 26 26 26 50 48 48 48 48 48 48 48 48 -1 -1 -1 -1 -1 -1 -1 -1 -1 94 49 72 49 -1 -1 -1 -1 -1 -1 -1 -1 -1 -1 -1 -1 -1 -1 -1 -1 -1 -1 -1 -1 -1 -1 94 48 48 48 48 48 48 -1 382 382 382 -1 -1 -1 94 48 72 72 72 72 72 72 162 141 141 377 377 377 377 377 377 377 141 141 141 141 141 141 49 49 49 49 49 49 49 49 49 49 49 49 49 492 -1 -1 -1 -1 -1 -1 49 49 49 49 49 -1 -1 -1 -1 -1 -1 -1 -1 -1 -1 -1 -1 -1 -1 -1 -1 -1 -1 -1 -1 -1 -1 -1 -1 -1 -1 -1 -1 49
50 50 26 3 3 3 3 3 3 3 3 3 3 3 3 3 3 3 3 3 3 3 3 3 -1 -1 -1 -1 -1 -1 -1 -1 -1 -1 -1 -1 -1 -1 -1 -1 71 117 141 141 141 141 141 141 48 48 -1 -1 -1 -1 -1 -1 27 27 -1 94 49 72 49 -1 -1 -1 -1 -1 -1 -1 -1 -1 -1 -1 -1 -1 -1 -1 -1 -1 -1 3 3 3 -1 94 48 48 48 48 48 48 382 382 382 382 -1 -1 -1 94 48 72 72 72 72 72 72 141 141 141 141 141 141 141 141 141 141 141 141 141 141 141 141 49 49 49 49 49 49 49 49 49 49 49 49 49 492 -1 -1 -1 -1 -1 -1 49 49 49 49 49 -1 -1 -1 -1 -1 -1 -1 -1 -1 -1 -1 -1 -1 -1 -1 -1 -1 -1 -1 -1 -1 -1 -1 -1 -1 -1 -1 -1 49
50 50 48 48 48 48 48 48 48 48 48 48 48 48 48 48 48 48 48 72 96 -1 -1 -1 -1 -1 -1 -1 -1 -1 -1 -1 -1 -1 -1 -1 -1 -1 -1 -1 71 117 141 141 141 141 141 141 48 48 -1 -1 -1 -1 -1 -1 -1 -1 -1 94 49 72 49 -1 -1 -1 -1 -1 -1 -1 -1 -1 -1 -1 -1 -1 -1 -1 -1 -1 -1 -1 -1 322 -1 94 48 48 48 48 48 48 382 -1 382 -1 -1 -1 -1 94 48 72 72 72 72 72 72 141 141 141 141 141 141 141 141 141 141 141 141 141 141 141 141 141 141 141 141 141 141 141 141 141 141 141 49 49 492 -1 -1 -1 -1 -1 -1 49 49 49 49 49 -1 -1 -1 -1 -1 -1 -1 -1 -1 -1 -1 -1 -1 -1 -1 -1 -1 -1 -1 -1 -1 -1 -1 -1 -1 -1 -1 -1 49
50 50 48 48 48 48 48 48 48 48 48 48 48 48 48 48 48 48 48 72 96 -1 -1 -1 -1 -1 -1 -1 -1 -1 -1 -1 -1 -1 -1 -1 -1 -1 -1 -1 71 117 141 141 141 141 141 141 48 48 -1 -1 -1 -1 -1 -1 -1 -1 -1 94 49 72 49 -1 -1 -1 -1 -1 -1 -1 -1 -1 -1 -1 -1 -1 -1 -1 -1 -1 -1 -1 322 322 -1 94 48 48 48 48 48 48 382 382 -1 -1 -1 -1 -1 94 48 72 72 72 72 72 72 139 141 141 141 141 141 141 141 141 141 141 141 141 141 141 141 141 141 141 141 141 141 141 141 141 141 141 49 49 492 -1 -1 -1 -1 -1 -1 49 49 49 49 49 -1 -1 -1 -1 -1 -1 -1 -1 -1 -1 -1 -1 -1 -1 -1 -1 -1 -1 -1 -1 -1 -1 -1 -1 -1 -1 -1 -1 49
50 50 48 48 48 48 48 48 48 48 48 48 48 48 48 48 48 48 48 48 73 -1 -1 -1 -1 -1 -1 59 60 61 -1 -1 -1 -1 -1 -1 -1 -1 -1 -1 50 117 141 141 141 141 141 141 48 48 -1 -1 -1 -1 -1 -1 -1 -1 -1 94 49 72 49 -1 -1 -1 -1 -1 -1 -1 -1 -1 -1 -1 -1 -1 -1 3 3 3 322 322 382 382 382 94 48 48 48 48 48 48 382 -1 -1 -1 -1 -1 -1 94 72 72 72 72 72 72 72 162 141 141 141 141 141 141 141 141 141 377 377 377 377 377 141 141 141 141 141 141 141 141 141 141 141 141 49 49 492 -1 492 492 27 27 423 49 49 49 49 49 243 243 243 -1 -1 -1 -1 -1 -1 448 448 448 27 27 -1 -1 -1 -1 -1 -1 -1 -1 -1 -1 -1 -1 -1 -1 49
50 50 48 -1 -1 -1 -1 -1 -1 -1 -1 -1 -1 -1 -1 -1 -1 -1 -1 -1 -1 -1 -1 -1 -1 2 2 2 2 2 2 -1 -1 -1 -1 -1 -1 -1 -1 -1 50 117 141 141 141 141 141 141 48 48 -1 -1 -1 -1 -1 -1 -1 -1 -1 94 49 72 49 -1 -1 -1 -1 -1 -1 -1 -1 -1 -1 -1 382 382 382 382 382 -1 -1 -1 -1 -1 382 94 48 48 48 48 48 48 0 3 3 -1 -1 -1 -1 94 72 72 72 72 72 72 72 141 141 141 141 141 141 141 141 141 141 141 141 141 141 141 141 141 141 141 141 141 141 141 141 141 141 141 49 49 492 -1 -1 -1 -1 -1 -1 49 49 49 49 49 243 243 243 -1 60 -1 -1 -1 -1 -1 -1 -1 -1 -1 -1 -1 -1 -1 -1 -1 -1 -1 -1 -1 -1 -1 -1 -1 49
50 50 48 -1 -1 -1 -1 -1 -1 -1 -1 -1 -1 -1 -1 -1 -1 -1 -1 -1 -1 -1 -1 -1 -1 -1 -1 -1 -1 -1 -1 -1 -1 -1 -1 -1 -1 -1 -1 -1 50 117 141 141 141 141 141 141 48 48 -1 27 27 -1 -1 -1 -1 -1 -1 94 95 95 49 -1 -1 -1 -1 -1 -1 -1 382 382 382 382 382 382 382 382 382 382 382 -1 -1 -1 -1 94 48 48 48 48 48 48 0 -1 -1 -1 -1 -1 -1 94 72 72 72 72 72 72 72 139 141 141 141 141 141 141 141 466 466 141 141 141 141 141 141 141 141 141 141 141 141 141 141 141 141 141 49 49 -1 -1 -1 -1 -1 -1 -1 49 49 49 49 49 243 27 27 27 27 27 27 -1 -1 -1 -1 -1 -1 -1 -1 -1 -1 -1 -1 -1 -1 -1 -1 -1 -1 -1 -1 -1 49
50 50 48 -1 -1 -1 -1 -1 -1 -1 -1 -1 -1 -1 -1 -1 -1 -1 -1 -1 -1 -1 -1 -1 -1 -1 -1 -1 -1 -1 -1 -1 -1 -1 -1 -1 -1 -1 -1 -1 50 117 141 141 141 141 141 141 48 48 -1 -1 -1 -1 -1 -1 -1 -1 -1 94 95 95 49 -1 -1 -1 -1 -1 382 382 382 382 382 382 382 382 382 382 382 382 382 382 -1 -1 -1 94 48 48 48 48 48 48 0 -1 -1 -1 -1 -1 -1 94 72 72 72 72 72 72 72 141 141 141 141 141 141 141 466 141 141 141 141 141 141 141 141 141 141 141 141 141 141 141 141 141 141 141 49 49 -1 -1 -1 -1 -1 -1 -1 49 49 49 49 49 -1 -1 -1 -1 -1 -1 -1 -1 -1 -1 -1 -1 -1 -1 -1 -1 -1 -1 -1 -1 -1 470 470 -1 -1 -1 -1 -1 49
50 50 48 -1 -1 -1 -1 -1 -1 -1 -1 -1 -1 -1 -1 -1 -1 -1 -1 -1 -1 -1 -1 -1 -1 -1 -1 -1 -1 -1 -1 -1 -1 -1 -1 -1 -1 -1 -1 -1 50 117 141 141 141 141 141 141 48 48 -1 -1 -1 -1 -1 -1 -1 -1 -1 0 0 0 23 -1 -1 -1 -1 -1 382 382 382 3 3 3 382 382 382 382 382 382 -1 -1 -1 -1 -1 94 48 48 48 48 48 48 0 -1 -1 -1 -1 -1 -1 94 72 72 72 72 72 72 72 141 141 141 141 141 141 141 141 141 141 141 141 141 141 141 141 141 377 377 377 377 141 141 141 141 141 141 49 49 -1 27 27 -1 -1 -1 -1 49 49 49 49 49 -1 -1 -1 -1 -1 -1 -1 -1 -1 -1 -1 -1 -1 -1 -1 -1 -1 -1 -1 -1 283 283 283 283 283 -1 -1 -1 49
50 50 48 -1 -1 -1 -1 -1 -1 -1 -1 -1 -1 -1 -1 -1 -1 -1 -1 -1 -1 -1 -1 -1 -1 -1 -1 -1 -1 -1 -1 -1 -1 -1 2 24 24 24 24 24 50 117 141 141 141 141 141 141 48 48 -1 -1 -1 -1 -1 -1 3 3 -1 -1 0 0 0 -1 -1 -1 -1 -1 -1 382 382 382 382 382 382 382 382 382 382 382 382 382 -1 -1 -1 94 48 48 48 48 48 48 0 -1 -1 3 3 -1 -1 141 141 141 141 141 141 141 141 141 141 141 141 141 141 141 141 141 141 141 141 141 141 141 141 141 141 141 141 141 141 141 141 141 141 141 49 49 -1 -1 -1 -1 -1 -1 -1 49 49 49 49 49 -1 -1 -1 -1 -1 -1 -1 -1 -1 -1 -1 -1 -1 -1 -1 -1 -1 -1 -1 283 283 283 283 283 283 283 283 283 283
50 50 48 -1 -1 -1 -1 -1 -1 -1 -1 -1 -1 -1 -1 -1 -1 -1 -1 -1 -1 -1 -1 -1 -1 -1 -1 -1 -1 -1 -1 -1 -1 -1 -1 -1 -1 -1 -1 -1 50 117 141 141 141 141 141 141 48 48 -1 -1 -1 -1 -1 -1 -1 -1 -1 -1 0 0 0 -1 -1 -1 -1 -1 -1 -1 -1 -1 -1 -1 -1 -1 -1 -1 -1 -1 -1 -1 -1 -1 0 94 48 48 48 48 48 48 0 -1 -1 -1 -1 -1 0 141 141 141 141 141 141 141 141 141 141 141 141 141 141 141 141 141 141 141 141 141 141 141 141 141 141 141 141 141 141 141 141 141 141 141 49 49 -1 -1 20 20 66 67 68 -1 -1 -1 -1 -1 -1 -1 -1 -1 -1 -1 -1 -1 -1 -1 -1 -1 -1 -1 -1 -1 470 470 470 283 316 316 316 316 316 283 283 283 283
50 50 48 -1 -1 -1 -1 -1 -1 -1 -1 -1 -1 -1 -1 -1 -1 -1 -1 -1 -1 -1 -1 -1 -1 -1 -1 -1 -1 -1 -1 -1 -1 -1 -1 -1 -1 -1 -1 -1 50 117 141 141 141 141 141 141 48 48 -1 -1 -1 -1 -1 -1 -1 -1 -1 0 0 0 0 0 0 -1 -1 -1 -1 -1 -1 -1 -1 -1 -1 -1 -1 -1 3 3 3 322 -1 -1 0 94 48 48 48 48 48 48 -1 -1 -1 -1 -1 -1 0 141 141 141 141 141 141 141 141 141 141 141 141 141 141 141 141 141 141 141 141 141 141 141 141 141 141 141 141 466 141 141 141 141 141 141 49 49 -1 -1 20 20 89 90 91 -1 -1 -1 -1 -1 -1 -1 -1 -1 -1 -1 -1 -1 -1 -1 -1 -1 -1 -1 -1 -1 470 470 -1 283 316 316 316 316 316 283 283 283 283
50 50 48 -1 -1 -1 -1 -1 -1 -1 -1 -1 -1 -1 -1 -1 -1 -1 -1 -1 -1 -1 -1 11 12 -1 -1 -1 -1 -1 -1 -1 -1 -1 -1 11 12 -1 -1 -1 50 117 141 141 141 141 141 141 48 48 -1 -1 -1 -1 -1 -1 -1 -1 -1 -1 -1 -1 -1 15 16 -1 -1 -1 -1 -1 -1 -1 -1 -1 -1 -1 -1 -1 -1 -1 -1 -1 -1 -1 -1 94 48 48 48 48 48 48 -1 -1 -1 -1 -1 -1 -1 141 141 141 141 141 141 141 141 141 141 141 141 141 141 141 141 141 141 141 141 141 141 141 141 141 141 141 141 141 141 377 377 377 141 141 49 49 -1 -1 110 111 112 113 114 -1 -1 -1 -1 -1 15 16 17 -1 -1 -1 15 16 17 -1 -1 -1 -1 -1 -1 -1 470 81 -1 283 316 316 316 316 316 283 283 283 283
50 50 48 -1 -1 -1 -1 -1 -1 -1 -1 11 12 -1 -1 -1 -1 -1 -1 -1 24 3 24 24 24 24 24 24 24 24 24 24 24 24 24 24 24 24 24 24 71 117 141 141 141 141 141 141 48 48 -1 -1 -1 -1 60 -1 -1 -1 -1 -1 -1 -1 -1 38 39 -1 -1 -1 -1 -1 -1 -1 382 382 382 382 382 382 -1 -1 -1 -1 -1 -1 -1 94 48 48 48 48 48 48 -1 -1 -1 -1 -1 -1 -1 94 72 72 72 72 72 72 72 141 141 141 141 141 141 141 141 141 141 141 141 141 141 141 141 141 141 141 141 141 141 141 141 141 141 141 49 143 449 449 20 134 135 136 137 449 449 449 449 449 38 39 40 449 449 449 38 39 40 -1 -1 -1 -1 -1 -1 -1 150 104 -1 283 316 316 316 316 316 283 283 283 283
50 50 48 24 24 24 24 24 24 24 24 24 24 24 24 24 24 24 24 24 71 71 71 71 71 71 71 71 71 71 71 71 71 71 71 71 72 71 71 71 71 117 141 141 141 141 141 141 48 48 3 3 3 3 3 3 3 3 3 3 3 3 3 3 3 3 3 3 3 3 3 3 382 382 382 382 382 382 382 382 382 3 3 3 3 48 48 48 48 48 48 48 -1 -1 -1 -1 -1 -1 -1 94 72 72 72 72 72 72 72 141 141 141 141 141 141 141 141 141 141 141 141 141 141 141 141 141 141 141 141 141 141 141 141 141 141 141 49 3 3 3 3 3 3 3 3 3 3 3 3 3 3 3 3 3 3 3 3 3 3 -1 -1 -1 -1 -1 -1 -1 3 3 3 3 3 3 3 3 3 3 3 3 3
71 71 48 71 71 71 71 71 71 71 71 71 71 71 71 71 71 71 71 71 71 71 71 71 71 71 71 71 71 71 71 71 71 71 71 72 72 71 71 71 71 117 141 141 141 141 141 141 48 48 48 48 48 48 48 48 48 48 48 48 48 48 48 48 48 48 48 48 48 48 48 48 382 382 382 382 382 382 382 382 382 48 48 48 48 48 48 48 48 48 48 -1 -1 -1 -1 -1 -1 -1 -1 94 48 72 72 72 72 72 72 209 209 209 209 209 210 210 141 141 141 141 141 210 209 210 210 209 210 210 209 210 210 209 210 209 209 210 210 49 49 49 49 49 49 49 49 49 49 49 49 49 49 49 49 49 49 49 49 49 49 -1 -1 -1 -1 -1 -1 -1 49 49 49 49 49 49 49 49 49 49 49 49 49
71 71 71 71 71 71 71 71 71 71 71 71 71 71 71 71 71 71 71 71 71 71 71 71 71 71 71 72 72 72 72 72 72 72 72 72 72 71 71 71 71 117 141 141 141 141 141 141 48 72 48 48 48 48 48 48 48 48 48 48 48 48 48 48 48 48 48 48 48 48 48 48 3 3 3 3 3 3 3 3 3 48 48 48 48 48 48 49 49 49 49 -1 -1 -1 -1 -1 -1 -1 -1 72 48 72 72 72 72 72 72 50 50 50 50 50 50 50 -1 -1 -1 -1 -1 72 72 72 50 50 50 50 50 50 50 50 50 50 50 50 50 49 49 49 49 49 49 49 49 49 49 49 49 49 49 49 49 49 49 49 49 49 49 -1 -1 -1 -1 -1 -1 -1 49 49 49 49 49 49 49 49 49 49 49 49 49
71 71 71 71 71 71 71 71 71 71 71 71 71 71 71 71 71 140 140 140 140 140 140 140 72 72 72 72 72 72 72 72 72 72 72 72 72 72 72 72 72 117 141 141 141 141 141 141 48 48 72 72 72 72 72 72 72 72 72 72 72 72 72 72 72 72 72 72 72 72 72 72 72 72 72 72 72 72 72 72 72 72 72 72 72 72 72 49 49 49 49 -1 -1 -1 -1 -1 -1 -1 -1 72 48 72 72 72 72 72 72 50 50 50 50 50 50 50 -1 -1 -1 -1 -1 50 50 50 50 50 50 50 50 50 50 50 50 50 50 50 50 49 49 49 49 49 49 49 49 49 49 49 49 49 49 49 49 49 49 49 49 49 49 -1 -1 -1 -1 -1 -1 -1 49 49 49 49 49 49 49 49 49 49 49 49 49
140 140 140 140 140 140 140 140 140 140 140 140 140 140 140 140 140 140 140 140 140 140 140 140 140 140 72 72 72 72 72 72 72 72 72 72 72 72 72 72 72 117 141 141 141 141 141 141 48 72 72 72 72 72 72 72 72 72 72 72 72 72 72 72 72 72 72 72 72 72 72 72 72 72 72 72 72 72 72 72 72 72 72 72 72 72 72 49 49 49 49 -1 -1 -1 -1 -1 -1 -1 -1 48 48 72 72 72 72 72 72 50 50 50 50 50 50 50 -1 -1 -1 -1 -1 50 50 50 50 50 50 50 50 50 50 50 50 50 50 50 50 49 49 49 49 49 49 49 49 49 49 49 49 49 49 49 49 49 49 49 49 49 49 -1 -1 -1 -1 -1 -1 -1 49 49 49 49 49 49 49 49 49 49 49 49 49
140 140 140 140 140 140 140 140 140 140 140 140 140 140 140 140 140 140 140 140 140 140 140 140 140 140 140 72 72 72 72 72 72 72 72 72 72 72 72 72 72 117 141 141 141 141 141 141 48 48 72 72 72 72 72 72 72 72 72 72 72 72 72 72 72 72 72 72 72 72 72 72 72 72 72 72 72 72 72 72 72 72 72 72 72 72 72 49 49 49 49 -1 -1 -1 -1 -1 -1 -1 -1 48 48 72 72 72 72 72 72 50 50 50 50 50 50 50 -1 -1 -1 -1 -1 50 50 50 50 50 50 50 50 50 50 50 50 50 50 50 50 49 49 49 49 49 49 49 49 49 49 49 49 49 49 49 49 49 49 49 49 49 49 -1 -1 -1 -1 -1 -1 -1 49 49 49 49 49 49 49 49 49 49 49 49 49
140 140 140 140 140 140 140 140 140 140 140 140 140 140 140 140 140 140 140 140 140 140 140 140 140 140 140 72 72 72 72 72 72 72 72 72 72 72 72 72 72 117 141 141 141 141 141 141 48 72 72 72 72 140 140 140 140 140 140 140 140 140 140 140 140 140 140 140 140 140 140 140 140 140 140 140 140 140 140 140 140 140 140 72 72 72 72 49 49 49 49 -1 -1 -1 -1 -1 -1 -1 -1 72 48 72 72 72 72 72 72 50 50 50 50 50 50 50 -1 -1 -1 -1 -1 50 50 50 50 50 50 50 50 50 50 50 50 50 50 49 49 49 49 49 49 49 49 49 49 49 49 49 49 49 49 49 49 49 49 49 49 49 49 -1 -1 -1 -1 -1 -1 -1 49 49 49 49 49 49 49 49 49 49 49 49 49
140 140 140 140 140 140 140 140 140 140 140 140 140 140 140 140 140 140 140 140 140 140 140 140 140 140 140 72 72 72 72 72 72 72 72 72 72 72 72 72 72 117 141 141 141 141 141 141 48 72 72 72 72 140 140 140 140 140 140 140 140 140 140 140 140 140 140 140 140 140 140 140 140 140 140 140 140 140 140 140 140 140 140 72 72 72 72 49 49 49 49 -1 -1 -1 -1 -1 -1 -1 -1 72 48 72 72 72 72 72 72 50 50 50 50 50 50 50 -1 -1 -1 -1 -1 50 50 50 50 50 50 50 50 50 50 50 50 50 50 50 49 49 49 49 49 49 49 49 49 49 49 49 49 49 49 49 49 49 49 49 49 49 49 -1 -1 -1 -1 -1 -1 -1 49 49 49 49 49 49 49 49 49 49 49 49 49
140 140 140 140 140 140 140 140 140 140 140 140 140 140 140 140 140 140 140 140 140 140 140 140 140 140 140 72 72 72 72 72 72 72 72 72 72 72 72 72 72 117 141 141 141 141 141 141 48 72 72 72 72 140 140 140 140 140 140 140 140 140 140 140 140 140 140 140 140 140 140 140 140 140 140 140 140 140 140 140 140 140 140 72 72 72 72 49 49 49 49 -1 -1 -1 -1 -1 -1 -1 -1 72 48 72 72 72 72 72 72 72 50 50 50 50 50 50 -1 -1 -1 -1 -1 50 50 50 50 50 50 50 50 50 50 50 50 50 50 50 50 49 49 49 49 49 49 49 49 49 49 49 49 49 49 49 49 49 49 49 49 49 49 -1 -1 -1 -1 -1 -1 -1 49 49 49 49 49 49 49 49 49 49 49 49 49
