53 53 53 53 53 53 53 53 53 53 53 53 53 53 53 53 53 53 53 53 53 53 53 53 53 53 53 53 53 53 53 53 53 53 53 53 53 53 53 53 53 53 53 53 53 53 53 53 53 53 53 53 53 53 53 53 53 53 53 53
53 53 53 53 53 53 53 53 53 53 53 53 53 53 53 53 53 53 53 53 53 53 53 53 53 53 53 53 53 53 53 53 53 53 53 53 53 53 53 53 53 53 53 53 53 53 53 53 53 53 53 53 53 53 53 53 53 53 53 53
54 28 28 28 28 103 103 28 28 28 28 28 28 28 28 28 28 28 28 28 28 28 28 28 28 28 28 28 28 28 28 28 28 28 28 28 28 28 28 28 28 28 28 28 28 28 28 28 28 28 28 28 28 28 28 28 53 53 53 53
55 -1 -1 -1 -1 -1 -1 -1 -1 -1 -1 -1 -1 -1 -1 -1 -1 -1 -1 -1 -1 -1 -1 -1 -1 -1 -1 -1 -1 -1 -1 -1 76 52 78 80 -1 -1 -1 -1 -1 -1 -1 -1 -1 -1 -1 -1 -1 -1 -1 -1 -1 -1 -1 51 53 53 53 53
55 -1 -1 -1 -1 -1 -1 -1 -1 -1 -1 -1 -1 -1 -1 -1 -1 -1 -1 -1 -1 -1 -1 -1 -1 -1 -1 -1 -1 -1 -1 -1 -1 51 55 -1 -1 -1 -1 -1 -1 -1 -1 -1 -1 -1 -1 -1 -1 -1 -1 -1 -1 -1 -1 51 53 53 53 53
55 -1 -1 -1 -1 -1 -1 -1 -1 -1 -1 -1 -1 -1 -1 -1 -1 -1 -1 -1 -1 -1 -1 -1 -1 -1 -1 -1 -1 -1 -1 -1 -1 51 55 -1 -1 -1 -1 -1 -1 -1 -1 -1 -1 -1 -1 -1 -1 -1 -1 -1 -1 -1 -1 51 53 53 53 53
55 -1 -1 -1 -1 -1 -1 -1 -1 -1 -1 -1 -1 -1 2 3 3 3 3 3 3 3 3 3 3 3 3 4 -1 -1 -1 -1 -1 51 55 -1 -1 -1 -1 -1 -1 -1 -1 -1 -1 -1 -1 -1 -1 -1 2 3 3 3 3 28 53 53 53 53
55 -1 -1 -1 -1 -1 -1 -1 -1 -1 -1 -1 -1 -1 -1 -1 -1 -1 -1 -1 76 28 127 128 128 128 129 55 -1 -1 -1 -1 -1 51 28 3 4 -1 -1 -1 -1 -1 -1 -1 -1 -1 -1 -1 -1 -1 -1 -1 -1 -1 -1 51 53 53 53 53
55 -1 -1 -1 -1 -1 -1 -1 -1 -1 -1 -1 -1 -1 -1 -1 -1 -1 -1 -1 -1 51 151 152 178 154 155 55 -1 -1 -1 -1 -1 51 28 28 80 -1 -1 -1 -1 -1 2 3 3 3 3 4 -1 -1 -1 -1 -1 -1 -1 51 53 53 53 53
52 3 3 3 3 3 3 3 3 3 3 3 4 -1 -1 -1 -1 -1 -1 -1 -1 51 176 178 178 178 180 55 -1 -1 -1 -1 -1 51 55 -1 -1 -1 -1 -1 -1 -1 51 53 53 53 53 28 30 -1 -1 -1 -1 -1 -1 51 53 53 53 53
52 53 53 53 53 53 53 53 53 104 -1 -1 -1 -1 -1 -1 -1 -1 -1 -1 -1 51 176 178 178 178 180 55 -1 -1 -1 2 3 51 55 -1 -1 -1 -1 26 3 3 28 53 53 53 53 53 28 3 4 -1 -1 -1 -1 51 53 53 53 53
52 53 53 53 53 53 53 53 55 -1 -1 -1 -1 -1 -1 -1 -1 -1 -1 -1 -1 51 176 178 178 178 180 55 -1 -1 -1 -1 -1 51 55 -1 -1 -1 -1 51 53 53 53 53 53 53 53 53 53 103 104 -1 -1 -1 -1 51 53 53 53 53
79 103 103 103 103 103 103 103 104 -1 -1 -1 -1 2 2 3 4 -1 -1 -1 -1 51 176 178 178 178 180 55 -1 -1 -1 -1 -1 51 55 -1 -1 -1 -1 76 103 103 103 103 103 103 103 103 80 -1 -1 -1 2 3 3 28 53 53 53 53
55 -1 -1 -1 -1 -1 -1 -1 -1 -1 -1 -1 -1 -1 -1 -1 -1 -1 -1 -1 -1 51 176 178 178 178 180 55 -1 -1 -1 -1 -1 51 55 -1 -1 -1 -1 -1 -1 -1 -1 -1 -1 -1 -1 -1 -1 -1 -1 -1 51 53 53 53 53 53 53 53
55 -1 -1 -1 -1 -1 -1 -1 -1 -1 -1 -1 -1 -1 -1 -1 -1 -1 -1 -1 -1 51 176 178 178 178 180 28 3 4 -1 -1 -1 51 55 -1 -1 -1 -1 -1 -1 -1 -1 -1 -1 -1 -1 -1 -1 -1 -1 -1 51 53 53 53 53 53 53 53
55 -1 -1 -1 -1 -1 -1 -1 -1 -1 -1 -1 -1 -1 -1 -1 -1 -1 26 3 3 28 176 178 178 178 180 55 -1 -1 -1 -1 -1 51 55 -1 -1 -1 -1 -1 -1 -1 -1 -1 -1 -1 -1 -1 -1 2 3 3 28 28 28 28 53 53 53 53
55 -1 -1 -1 -1 -1 -1 -1 -1 -1 -1 -1 -1 -1 -1 -1 -1 -1 -1 -1 -1 51 176 178 178 178 180 55 -1 -1 -1 -1 -1 51 55 -1 -1 -1 -1 -1 -1 -1 -1 -1 -1 -1 -1 -1 -1 -1 -1 -1 -1 -1 -1 51 53 53 53 53
55 -1 -1 -1 -1 -1 -1 -1 -1 -1 -1 -1 -1 -1 -1 -1 -1 -1 -1 -1 -1 51 176 178 178 178 180 55 -1 -1 -1 2 3 51 55 -1 -1 -1 -1 -1 -1 -1 -1 -1 -1 -1 -1 -1 -1 -1 -1 -1 -1 -1 -1 51 53 53 53 53
55 -1 -1 -2 -1 -1 -1 -1 -1 26 3 3 3 3 3 3 3 3 3 3 3 28 176 177 178 179 180 55 -1 -1 -1 -1 -1 51 55 -1 -1 -1 -1 -1 -1 -1 -1 2 3 3 4 -1 -1 -1 -1 -1 -1 -1 -1 51 53 53 53 53
78 3 3 3 3 3 3 3 3 28 28 28 28 28 28 28 28 28 28 28 28 28 176 177 178 179 180 28 -1 -1 -1 -1 -1 51 55 -1 -1 -1 -1 -1 -1 -1 -1 -1 -1 -1 -1 -1 -1 -1 -1 -1 -1 -1 -1 51 53 53 53 53
28 52 52 52 52 52 52 52 52 28 53 53 53 53 53 53 53 53 53 53 53 53 176 177 178 179 180 55 -1 -1 -1 -1 -1 51 55 -1 -1 -1 -1 -1 -1 -1 -1 -1 -1 -1 -1 -1 -1 -1 -1 -1 -1 -1 -1 51 53 53 53 53
53 53 53 53 53 53 53 53 53 53 128 128 128 128 151 128 128 128 128 128 128 128 152 177 178 179 180 55 -1 -1 -1 -1 -1 102 104 -1 -1 -1 -1 -1 -1 -1 -1 -1 -1 -1 -1 -1 3 3 3 -1 -1 -1 -1 51 53 53 53 53
127 128 128 128 128 128 128 128 128 128 152 153 153 153 178 178 178 178 178 178 178 178 178 177 178 179 180 55 -1 -1 -1 -1 -1 -1 -1 -1 -1 -1 -1 -1 -1 -1 -1 -1 3 3 3 3 3 -1 -1 -1 -1 -1 -1 51 53 53 53 53
178 178 178 178 178 178 178 178 178 178 178 178 178 178 178 178 178 178 178 178 178 178 178 177 178 179 180 55 -1 -1 -1 -1 -1 -1 -1 -1 -1 -1 -1 -1 -1 -1 -1 -1 102 103 103 103 104 -1 -1 -1 -1 -1 -1 51 53 53 53 53
178 178 178 178 178 178 178 178 178 178 178 178 178 178 178 178 178 178 178 178 178 178 178 177 178 179 180 55 -1 -1 -1 -1 -1 -1 -1 -1 -1 -1 -1 -1 -1 -1 -1 -1 -1 -1 -1 -1 -1 -1 -1 -1 -1 -1 -1 51 53 53 53 53
178 178 178 178 178 178 178 178 178 178 178 178 178 178 178 178 178 178 178 178 178 178 178 178 178 178 205 28 3 3 3 3 3 3 3 3 3 3 3 3 3 4 -1 -1 -1 -1 -1 -1 -1 -1 -1 3 3 3 3 28 53 53 53 53
178 178 178 178 178 178 178 178 178 178 178 178 178 178 178 178 178 178 178 178 178 178 178 178 178 178 53 53 28 28 28 28 28 28 28 28 28 28 28 28 28 55 -1 -1 -1 -1 -1 -1 -1 -1 -1 51 28 28 28 28 53 53 53 53
178 178 178 178 178 178 178 178 178 178 178 178 178 178 178 178 178 178 178 178 178 178 178 178 178 178 178 128 128 128 128 128 128 128 128 128 128 128 128 128 53 55 -1 -1 -1 -1 -1 -1 -1 -1 -1 28 53 53 53 53 53 53 53 53
178 178 178 178 178 178 178 178 178 178 178 178 178 178 178 178 178 178 178 178 178 178 178 178 178 178 178 178 178 178 178 178 178 178 178 178 178 178 178 154 180 28 3 3 3 -1 -1 -1 3 3 3 28 53 53 53 53 53 53 53 53
178 178 178 178 178 178 178 178 178 178 178 178 178 178 178 178 178 178 178 178 178 178 178 178 178 178 178 178 178 178 178 178 178 178 178 178 178 178 178 178 180 28 28 28 28 3 3 3 28 28 28 28 53 53 53 53 53 53 53 53
178 178 178 178 178 178 178 178 178 178 178 178 178 178 178 178 178 178 178 178 178 178 178 178 178 178 178 178 178 178 178 178 178 178 178 178 178 178 178 178 155 53 53 53 53 53 53 53 53 53 53 53 53 53 53 53 53 53 53 53
